#########################
#o.....................o#
#o.....................o#
#.####..###   ###..####.#
 .#  #..#       #..#  #. 
#.#  #..#########..#  #.#
#.####.............####.#
#o.......{oM.........?.o#
#########################